18if|18if
Action Heroine Cheer Fruits|アクションヒロイン チアフルーツ
Aho Girl|アホガール
Aikatsu Stars|アイカツスターズ！
Ballroom e Youkoso|ボールルームへようこそ
Battle Girl High School|バトルガールハイスクール
Boku no Hero Academia 2|僕のヒーローアカデミア2
Centaur no Nayami|セントールの悩み
Clione no Akari|クリオネの灯り
Digimon Universe|デジモンユニバース アプリモンスターズ
Dive!|DIVE！！
Enmusubi no Youko-chan|縁結びの妖狐ちゃん
Fate - Apocrypha|Fate／Apocrypha
Gamers|ゲーマーズ！
Hajimete no Gal|はじめてのギャル
Himitsu no Cocotama|かみさまみならい ヒミツのここたま
Hina Logi|ひなろじ～from Luck＆Logic～
Hitorijime My Hero|ひとりじめマイヒーロー
Idol Time PriPara|アイドルタイムプリパラ
Ikemen Sengoku|イケメン戦国◆時をかけるが恋ははじまらない
Ise Kanegasaki Hen|信長の忍び～伊勢・金ヶ崎篇～
Isekai Shokudou|異世界食堂
Isekai wa Smartphone to Tomo ni|異世界はスマートフォンとともに。
Jigoku Shoujo - Yoi no Togi|地獄少女 宵伽
Jikan no Shihaisha|時間の支配者
Kaito x Ansa|カイトアンサ
Kakegurui|賭ケグルイ
Katsugeki - Touken Ranbu|活撃 刀剣乱舞
Keppeki Danshi|潔癖男子！青山くん
Knight's|ナイツ＆マジック
Koi to Uso|恋と嘘
Konbini Kareshi|コンビニカレシ
Made in Abyss|メイドインアビス
Mahoujin Guru Guru|魔法陣グルグル
Musekinin Galaxy Tylor|無責任ギャラクシー☆タイラー
Nanamaru Sanbatsu|ナナマルサンバツ
Nanatsu no Taizai|sin 七つの大罪
Netsuzou Trap|捏造トラップ-NTR-
New Game|NEW GAME！！
Nora to Oujo to Noraneko Heart|ノラと皇女と野良猫ハート
Princess Principal|プリンセス・プリンシパル
Re.Creators|Re：CREATORS
Sagrada Reset|サクラダリセット
Saiyuuki Reload Blast|最遊記RELOAD BLAST
Sakura Quest|サクラクエスト
Senki Zesshou Symphogear AXZ|戦姫絶唱シンフォギアAXZ
Shingeki no Bahamut|神撃のバハムート VIRGIN SOUL
Shoukoku no Altair|将国のアルタイル
Skirt no Naka wa Kedamono Deshita|スカートの中はケダモノでした。
Tenshi no 3P|天使の3P！
Tsurezure Children|徒然チルドレン
Vatican Kiseki Chousakan|バチカン奇跡調査官
Youkai Apartment no Yuuga na Nichijou|妖怪アパートの幽雅な日常
Youkoso Jitsuryoku Shijou Shugi no Kyoushitsu e|ようこそ実力至上主義の教室へ
